31 15
1111111111111111111111111111111
1000000000000001000000000000001
1000000000000001000000000000001
1000000000000001000000000000001
100000000000000100000000000000E
100000000000000100000000000000E
100000000000000100000000000000E
100000000000000000000000000000E
100000001000000000000010000000E
100000001000000000000010000000E
100000001000000000000010000000E
1000000010000000000000100000001
1000000010000000000000100000001
1000000010000000000000100000001
1111111111111111111111111111111