31 15
111111111111111111111111EEEEEE1
1000000000000000000000000000001
1000000000000000000000000000001
1000000000000000000000000000001
1111111000000000000000001111111
1000000000000000000000000000001
1000000000000000000000000000001
1000000000000000000000000000001
1000000000001111111000000000001
1000000000000000000000000000001
1000000000000000000000000000001
1000000000000000000000000000001
1000000000000000000000000000001
1000000000000000000000000000001
1111111111111111111111111111111