31 15
1111111111111111111111111111111
1000000000000001000000000000001
1000000000000001000000000000001
1000000000000001000000000000001
1000000000000001000000000000001
1000000000000001000000000000001
1000000000000000000000000000001
1000000000000000000000000000001
1000000000000000000000000000001
1000000010000000000000000000001
1000000010000000000000100000001
1000000010000000000000100000001
1000000010000000000000100000001
1000000010000000000000100000001
11EEEEE111111111111111111111111